0000000000000000000000000
0wwwww2wwwww2wwwww2wwwww0
0222222222222222222222220
0zz2zz2x1x1x1x1x1x2zz2zz0
0zz2zz2111111111112zz2zz0
0222222x1x1x1x1x1x2222220
0wwwww2111111111112wwwww0
0222222x1x1x1x1x1x2222220
0zz2zz2111111111112zz2zz0
0zz2zz2x1x1x1x1x1x2zz2zz0
0222222222222222222222220
0wwwww2wwwww2wwwww2wwwww0
0000000000000000000000000
