2222222222222222222222222
2wwwww2wwwww2wwwww2wwwww2
2222222222222222222222222
2zz2zz2x1x1x1x1x1x2zz2zz2
2zz2zz2111111111112zz2zz2
2222222x1x1x1x1x1x2222222
2wwwww2111111111112wwwww2
2222222x1x1x1x1x1x2222222
2zz2zz2111111111112zz2zz2
2zz2zz2x1x1x1x1x1x2zz2zz2
2222222222222222222222222
2wwwww2wwwww2wwwww2wwwww2
2222222222222222222222222
