0000w0w0www0www
0ww000w00000000
00w0ww00ww0w0w0
0w00000www0w0w0
00wwww0ww0w000w
w000ww00w0www00
w0w0wwww00000ww
w0w0w0000www0w0
000ww0ww0w000w0
w0ww00000w0www0
w000wwww0w0000w
www0w0000www000
w000w0wwwwww00w
w0www0w00000000
w00000www0wwww0
